100
9898898989999898989988998889889889989999899888988889988999989888888888898998898898899889989988988888
9998899998899989899989889898899899888988988988899898889988898998898899888989888988888888988989888999
9999888899999999899889888999999888988899989898998989898999899988899889999988889888998889999899899998
8988998989998899898888999988889899889888988898989888988998889999998988899888989989998989888988988988
8988888998899898899889988888898899999989999989888899989899888889998989989989898899989988999988899998
9988989898899898888988898999998899889898988988989999889888999899889889899889898989898889899988998898
8888989998899898889898999899998899899898889998888889998989998989988898889898888898888898989898999899
9989888889999999999889888988998989998888999889898989888988889988888898899888889899888999998988989899
9899988998989899889899888898998888989888899898988899889998889889899999888888988999988899988899988988
8989898888999999999888889898889988988988998889988998898888898999999898988998899999998988898998889888
9889989989898999989999999998898989898889898889998888988988999889998899898988988999988889889988898989
9899888898899889988999999989998889898888899989988889898999888999889899889998989999999899888899989988
9888889888998988888888999889999998999999999899998888989988899888999998998998989998889888899898888988
8988988999989899999988889899988989999889999989889988889888989999988888998899899999998988889889889898
8889998898988889898898998989898998998989899989988898989898899988898998998998989899989888988889889998
9988888899899989998888989988888889988899888998999888989999888889898899999989988898988999899889988998
8899888988999988999988988898898898999889988888889889988889898989998999889899898888998988889989999999
8988989899898999988998888999898989999988888998898988899998989988999989899898898888889999989989889988
9889899998999999888889888989999989888988899998988888889999888888898889898988888998988998889998998888
8998889989899898888998988989988889898888999898888989898988989998898998998999999898989898989888999888
8899999989999898898999898899888898888999989989988899998999989998888889999898899899899889998888989898
9989898999989998998999998988898998898888898898989989999898988999889999899988988898889999998998889989
9888899899898888899888999988889898898999998988998898899888989999998888889989989998998998899998999988
8998898888989989899988898988999889898889989988988898998888899899889898898988998898998899989888899999
8898999988989889988899999889889999998899999888989899898989899988888888989889898989889988898889989998
9998898989998989898889888899888998898999889989999998889998898999999998988888889999888999999998889989
9899898888888998998899999998988998998899989888989889999989989889989899998988988889989999988899989889
9899999889988999998888888988888989888898988988989888988989998998999899998899898888899889999999998889
9899888889998988888889989889988899989999998998898888999999999899999998989889988899898988989998989889
8989889899899998989999989899889889888888989898998999989998988988999899999898988889889989989899998889
9989898999999898888988899998989999998899888999998898999999888889888898898998989999888889998989999988
9898988899898999988999999989899988889898998999889989988999898898989989989889899988899899888999898899
9988989899888988898999898998988989888898888999888899899898899888989888898898988989889888899999989889
9889988898998888999999989989899988989999999899998988898898988988989998999989888988898888998999898898
9999898888989998989888889898999998898999998999999898999888998999899999899998888989988899998888889889
9998898998989998998998899988898998888889888889989988898998998988988899989898989988889888999989889999
8998989999988888898898898899989999888989998888889898989998889989898889888899889888989989888988988888
9898988888988988999888988988999888989989888989888998899988989988998988898889999888898988899988988899
9988999889889889898899989999898889889999999988988899899988899899999988989988999999898888989898989999
8989988889989899889999898989888988989899989999898888998889888999898989988899888988899889989889898888
9988898889998989889888898989988888899889999999989898989999889988998899999888889888898889889889999888
9899888898889889888889998889888999898989898889989998988898998999989989888898999899999988888988999889
8989999899988889889998888889989989989898889898898989889888898998989989998999899888988999889889889889
8998988998888889899988889989898888889989998989898898989989988988888998988888898889999889989998898898
8999898989888998888888988989989999989998998898999999989998899898889998998988898889988998898988988898
8899999889889889888888998899988998989988889989899989989888999888888898998999988898999988899898989898
9889999999889999899988889899989999889999888998898889888898898889889999998899999988988988898989888998
9889999999898899988989899998989999898989989988989999988988989998999898898898999999899989999998999998
8899888899899888899888999898888988889889889888998898899899988898989888988888999888899899898899889889
9889898999888989999889899899898889988889998888888989999999998999998989999999988988889999988888988898
8899998898889888899999898989898889889998899888898998889989889989998888898989888988988899988898999898
9889899888889889999898899899889989998988888889899998898999999898989988989898989889988899989989989989
8898999899999988988998999999889989989989888889998989999988888989999898899989998999898998988898989898
8988888899988999898898999988998898889898988889989989899899999889998989899889999889988988999889998898
9999998899899989889898899898898999999899899888988989889898999998898889888888988988998889899898898998
9899888989989998988989998899998999998989898888889988999898988999998888889889988899989998999898899898
9999999999989899898998998898888888899899998998899989989989988998898998999998998989888889988989888988
9999888998999888888999888998988898999898899998988998889989989898989999898898898888988988898899888898
8988899888899899989988898999888899998999999989998889988899999889989998888899889889889988899888989898
8888998898898998898988889889899888998889998889988888889988989898989889988899998889888888998989888898
8989889899888899998989989898889989889889999888988888888899888898888989899988998899889989898898988888
8989888898898899989988898998989889989889888989899989988998888999888899888889988898999898888899999898
8898998999889899988989888999989889998999998899999888988888899989989898989898998998999998989999999999
8888989889988898898999998889989988889898888888898889888899889898899998999889998988988988988999989988
8899898899988989889989988989889988989989888889889899899999898988999989989998998989889888899998898988
9889888899989999988999998998988988889988898998888998899988988898898898988999889899888999898999899889
8898888998999998889889898899999989898888888999898888989989889889998989988888999989899889989899999988
8898889888899898988998889999998989889988888999989889898898999988988899988998888998899998988999999989
8888898889999899899889888998989989889898888898889898898889889988988889898899899998999999988989989989
8898898989998999898899899999988999899998989889989889998898889988998899989999999988989888888999998899
8998989898889889998898898888889889989988988989889888988888999989998898899998889898989989988889999998
8899988999998999899999888988988989888998988988899889989989988899999888889989989888999899899899989888
9998989988889988988999988889889898899989989998999898989889889888888999998888899999889898988988889999
9989989988998898999989889899899888888898999888998889999999999998889888889998899999988888998899989899
9999988988989889988888998999888888899888998889988998988889989889988898998999889989999999989889889988
8998888898889989889898899989989888899899998999899989998888888998989899888998898999899999899899989898
8999998898889898989998998889989989989999888899988998998988999999998899899999899898989889899899898988
9989998989999899999989999889989989998898889999899889999999998889889989898888888998998998888988998889
9898888888999989898989989989898899998998889989889989898898999898899889999888899888988889898889899898
9989889899998899998998888898989998989889898889898988899999899989898998999989999989999888988899898898
9898888888889988989888998998899999899889999899999999899889888899898889888898898999999999899989989899
8999888989989988899988999898999898999989988899898988889998999898998999998888899989988988898999999889
8898999999988998898889998899989888998899898899889899999988899989888888899888988899988999898999998899
9988988898988889999989999889888899888998999989988988889988899889888889888889898989888889889899988989
9898989888999889889898998998899889999899889898889888888888998899998889999988898998999888989988888888
8898898888888998888889999889998999889998998999899989989998888988998989988898888888888899888988898988
9988899999998899898989899898988898988889899899999889899888989889989888999898988998888988988998899999
9888989999888988889898899989999899988999998889998998999989998888998888899888898888988998899989899998
8888998999899998889888899888999989989989898898989899898899899989999989899989999999999988998998888989
8998988899988889888998888898899999998888888889888988988889899988898989999889889899988999999899999998
8889989889999889899998898999898988998999899889999989998888889899898989889899898899899899888988888989
9898989898998989999989998999889998898889889998898988889898999999889988998898888888889999998999889998
8888889899989888989998888888898888988898899998888998998898899888888999889888898889889988888899988989
9988998899989888988998898889898998988899899888989889889889999889989999999889999888899899998999898999
8998988989898998998898989898989898898898899999998988998999989998889989999988898998989988988988899988
9899989898988989999899888888998899898899888988998988988999998998889888989999898989998888999989889989
8989898898899998888988889898988888988899899999989988988888889988899899999898988999899889989999889889
9889988898898999988989898899999899889999999998989889888888898898988899899899989889999899889989989888
8998988998988999999888899998998999898989999888898889888898889989999889898998889888988898989888898999
8888889899889989889988888898888989889989888988989999988998999888999988898989889899988889889999888898