9898898989999898989988998889889889989999899888988889988999989888888888898998898898899889989988988888
999889999889998989998988X898899899888988988X888998X888998889899889889988898X888X88888888988989888999
9999888899999999899889888999999888X8889998X898998X8X8X8999899988899889999988889888998889999899899998
898899898999889989888899998888989988988898889898X888988998889999998988899888X89989998989888988X88988
898888899889989889988998888889889999998999998X888899989899888889998989989989898899989988999988899998
9988989898899898888X88898999998899889898988988X8999988988899989988X889899889898X898X888X899988998898
88889899988998988898X89998999988998998988899988888899989899989899888988898X88888988888989898X8999899
9989888889999999999889888X88998X8999888899988X8X8X8988898888998888889889988888X899888999998X88989899
989998899898989988989988889899888898X8888998X8988899889998889889899999888888X88999988899988899988X88
8X898X8888999999999888889898889988988X889988899889988X8888898999999898X88998899999998X888X899888X888
988998998X89899998999999999889898989888X898889998888X889889998899988998X89889889999888898899888X8989
98998888X889988998899999998999888989888889998998888X8X8999888999889899889998989999999899888899989988
988888X888998X88888888999889999998999999999899998888X89988899888999998998998989998889888899898888988
8X8898899998X899999988889899988989999889999989889988889888X89999988888998899899999998X88889889889898
88899988989888898988X89989898X8998998X898999899888X898989889998889899899899898989998X888X88889889998
9988888899899989998888989988888889988899888998999888989999888889898899999989988898988999899889988998
8899888X889999889999889888988988X89998899888888898899888898X8989998999889899898888998988889989999999
8X88X898998989999889988889998989899999888889988X8X88899998X89988999989899898898888889999989989889988
988X89999899999988888X888989999989888988899998X88888889999888888898889898988888998988998889998998888
8998889989899898888998X889899888898X8888999898888X89898988989998898998998999999898989898989888999888
88999999899998988989998988998888988889999899899888999989999899988888899998988998998998899988889898X8
99898989999899989989999989888X89988988888988X8989989999898988999889999899988988898889999998998889989
98888998998X8888899888999988889898898999998988998898899888989999998888889989989998998998899998999988
899889888898998989998889898899988989888998998898889899888889989988X8X88X8988998898998899989888899999
889899998898988998889999988988999999889999988898989989898X89998888888898X88X898989889988898889989998
9998898989998989898889888899888998898999889989999998889998898999999998988888889999888999999998889989
9899898888888998998899999998X8899899889998988898988999998998X889989899998X88X88889989999988899989889
98999998899889999988888889888889898888989889889898889889899989989998999988998X8888899889999999998889
989988888999898888888998988998889998999999899889888899999999989999999898988998889989898898999898X889
898988X899899998X8999998989988988988888898X898998999989998988X88999899999898988889889989989899998889
99898X8999999898888988899998X8999999889988899999889899999988888X888898898998989999888889998989999988
98X898889989899998899999998X89998888X8989989998899899889998988X898998998X88X899988899899888999898899
998898X899888988898999898998X8898X8888988889998888998998988998889898888988X8X8898X88988889999998X889
988998889899888899999998998X899988X89999999899998X8889889898898898999899998X8889888X88889989998X88X8
99998988889899989898888898X89999988X89999989999998X8999888998999899999899998888989988899998888889889
9998898998989998998998899988898998888889888889989988898998998988X88899989898X8998888988899998X889999
8998989999988888898898898899989999888989998888889898X8999888998X898889888899889888X8998X888988988888
9898988888988X88999888988988999888X8998988898X888998899988X899889989888X8889999888898988899988988899
998899988988988989889998999989888X889999999988X888998999888998999999889899889999998988889898X8989999
8989988889989899889999898989888X88X898999899998X8888998889888999898989988899888988899889989889898888
99888X8889998X89889888898989988888899889999999989898989999889988998899999888889888898889889889999888
989988889888X889888889998889888999898X89898889989998988898998999989989888898999899999988888X88999889
89899998999888898899988888899899899898X888X8X889898X88988889899898998999899989988898899988988X889889
89989889988888898999888899898X8888889989998X8X8988989899899889888889989888888988899998899899988X8898
89998989898889988888889889899899999899989988X89999999899988998X8889998998988898889988998898988988898
889999988988988988888899889998899898998888998X8999899898889998888888989989999888X89999888998X898X898
98899999998899998999888898999899998899998889988988898888X889888X88999999889999998898898889898X888998
988999999989889998898X8999989899998X8989989988989999988X88989998999898898898999999899989999998999998
889988889989988889988899989888898888X889889888998898899899988898989888988888999888899899898899889889
9889898999888X89999889899899898889988889998888888989999999998999998X89999999988988889999988888988898
8899998898889888899999898X898988898899988998888989988899898899899988888989898889889888999888X8999898
98898998888898899998988998998899899989888888898999988989999998X8989988X898X898X889988899989989989989
88X899989999998898899899999988998998998X888889998989999988888X899998X88999899989998X89989888X8989898
89888888999889998X8898999988998898889898X88889989989899899999889998X89899889999889988988999889998898
999999889989998988X898899898898999999899899888988989889898999998898889888888988X8899888X899898898998
9899888989989998X88989998899998999998X89898888889988999898988999998888889889988899989998999898899898
99999999999898998X8998998898888888899899998998899989989989988998898998999998998X89888889988X89888X88
9999888998999888888999888998X88898999898899998988998889989989898989999898898898888X88988898899888898
89888998888998999899888X899988889999899999998999888998889999988998999888889988X889889988899888X8X898
8888998898898998898988889889899888998889998889988888889988989898989889988899998889888888998X8X888898
898988X899888899998989989898889989889889999888988888888899888898888X8989998899889988998X898898988888
89898888988X88999899888X8998989889989889888X89899989988998888999888899888889988898999898888899999898
88X899899988X8999889898889999898899989999988999998889888888999899898989898X8998998999998989999999999
888898X8899888988X89999988899899888898988888888988898888998898X8899998999889998988988988988999989988
88998X8899988989889989988989889988X8998X88888X88X8998999998X8X8899998998999899898988X888899998898988
98898888999899999889999989989889888899888X8998888998899988X888X88988X8988999889899888999898999899889
889888899899999888X8898988999999898X88888889998X8888X8998X889889998X8998888899998989988998X899999988
889888X888899898X8899888999999898988998888899998988X8988X8999988988899988998888998899998988999999989
88888988899998998998898889989899898898988888988898X889888X8899889888898X8899899998999999988989989989
8898898X8999899989889989999998899989999898X8899898899988X8889988998899989999999988989888888999998899
899898X89888X88999889889888888X8899899889889898898889888889999899988988999988898X8989989988889999998
8899988999998999899999888X88X88X89888998988988899889989989988899999888889989989888999899899899989888
99989899888899889889999888898898X88999899899989998X8989889889888888999998888899999889898988X88889999
99899899889988X899998988X8998998888888X899988899888999999999999888X888889998899999988888998899989899
9999988988989889988888998999888888899888998889988998988889989889988898998999889989999999989889889988
899888889888998988989889998998988889989999899989998999888888899898X8998889988989998999998998999898X8
8999998898889898989998998889989989989999888899988998998988999999998899899999899898989889899899898X88
9989998X89999899999989999889989989998898889999899889999999998889889989898888888998998998888X88998889
98X88888889999898989899899898X88999989988899898899898988989998X889988999988889988898888X8X8889899898
998X88X899998899998998888898X89998989889898889898988899999899989898998999989999989999888X88899898898
98988888888899889898889989988999998998899998999999998998898888998988898888X8898999999999899989989899
8999888989989988899988999898999898999989988899898988889998999898998999998888899989988988898999999889
889899999998899889888999889998988899889989889988X899999988899989888888899888X88899988999898999998899
9988988898988889999989999889888899888998999989988X8888998889988988888988888X898989888889889899988X89
989898X8889998898898X8998998899889999899889898889888888888998899998889999988898998999888X89988888888
8898898888888998888889999889998999889998998999899989989998888X88998X89988898888888888899888988898988
99888999999988998X8X898998X898889898888989989999988989988898X88998X888999898X88998888988X88998899999
98889899998889888898X889998999989998899999888999899899998999888899888889988889888898899889998X899998
88889989998999988898888998889999899899898988X898X899898899899989999989899989999999999988998998888989
8998988899988889888998888898899999998888888889888988988889899988898989999889889899988999999899999998
88899898899998898999988989998989889989998998899999899988888898998989898898998X8899899899888988888989
98X8989898998X8999998999899988999889888988999889898888X898999999889988998898888888889999998999889998
888888989998988898999888888889888898889889999888899899889889988888899988988889888X889988888899988989
99889988999898889889988X888X89899898889989988898X88X88X889999889989999999889999888899899998999898999
8998988X898X8998998898X8X8X898X898898898899999998988998999989998889989999988898998989988988988899988
989998X898X88989999899888888998899898899888988998988988999998998889888989999898989998888999989889989
8X898X889889999888898888X898988888X88899899999989988988888889988899899999898988999899889989999889889
988998889889899998898X8988999998998899999999989898898888888X88X8988899899899989889999899889989989888
8998988998X889999998888999989989998X89899998888X8889888898889989999889898998889888988898X898888X8999
8888889899889989889988888898888989889989888988989999988998999888999988898989889899988889889999888898